*****************************************************
*****************************************************
**                     *********                   **
**                     *********                   **
**                                                 **
**                                                 **
*********      ************************      ********
*********      ************************      ********
**                     *********                   **
**                     *********                   **
**                     *********                   **
**                                                 **
*****************************************************
*****************************************************